NO ./mandatory/assets/bluestone.xpm
SO ./mandatory/assets/colorstone.xpm
EA ./mandatory/assets/eagle.xpm
WE ./mandatory/assets/graystone.xpm

F 100,50,0
C 50,150,255

        1111111111111111111111111
        1000000000010000000000001
        1001001111110011110000001
        1001000000000000011110001
111111111001011100010000000010001
100000000001010001110111111011111
11110111111101000100000010001
10000000100001000101110011101
10100000100101000101010000001
10100000100111011101000011101
10110000000000000101010010001
10011101110111011101011110N01
10000001 1000001 100000000001
11111111 1111111 111111111111