        1111111111111111111111111
        10000000000000000000000e1
111111111000111111101111110000001
1e0000000000100000000000010000001
100000e000000000000e00000111100e1
1e0000000000100000000000000011111
11110111111110000111101111111
1e00000e10e000000100000000e01
1000000010000000010e000000001
100e0000000000000111110111111
100000001000000001e00000000e1
10000001110000011100000000001
1e000001 10000e1 10000N000001
11111111 1111111 111111111111