        1111111111111111111111111
        1000000000000000000000001
1111111110001111111d1111110000001
100000000000100000000000010000001
100000000000d00000000000011110001
100000000000100000000000000011111
1111d1111111100001111d1111111
10000000100000000100000000001
10000000100000000100000000001
10000000d0000000011111d111111
10000000100000000100000000001
10000001110000011100000000001
10000001 1000001 10000N000001
11111111 1111111 111111111111