111111111111111111111111111111111111111111111111111111111111111111111111
100000000000000000000000000000000000000000111111111111111111111111111111
100010001010000101000000000100000000010000111111111111111111111111111111
101000000000000000000000000000001000000000111111111111111111111111111111
100000000100000010001000100s0000000s000000111111111111111111111111111111
100010ssssssssss00000000000010000000000000111111111111111111111111111111
100001ssssssssss0000100000000s00000W0000s0111111111111111111111111111111
100000ssssssssss00000000100000000000000000111111111111111111111111111111
100001ssssssssss0000100000s00001000s000000111111111111111111111111111111
100000ssssssssss01000001000000000000001000111111111111111111111111111111
100001ssssssssss00000000000000000000000000111111111111111111111111111111
100100010010000101000010010010000000100000111111111111111111111111111111
100000000000000000000000000000000000000000111111111111111111111111111111
111111111111111111111111111111111111111111111111111111111111111111111111