1111111111111111111111111111111111111111111
1e00000000000e00000000000000000000000e00001
1000100010100001010000000001000000000100001
10100e0000000000000000e00000000010000000001
1000000001000000100010001000000000000000e01
1000100000000100000000000000100000000000001
1000010000e000000000100000e00000000W0000001
1000e00001000000000000001000000000000000001
100001000000000e000010000000000100000000001
1000000001000000010000010000000000000010e01
1000010000001000000e00000000000e00000000001
1001000100100001010000100100100000001000001
1e000000000000e00000000000000000000000e0001
1111111111111111111111111111111111111111111