1111111111111111111111111111111111111111111
1000000000000000000000000000000000000000001
1000100010100001010000000001000000000100001
1010000000000000000000000000000010000000001
100000000100000010001000100s0000000s0000001
1000100000000100000000000000100000000000001
10000100000000000000100000000s00000W0000s01
1000000001000000000000001000000000000000001
10000100000000000000100000s00001000s0000001
1000000001000000010000010000000000000010001
1000010000001000000000000000000000000000001
1001000100100001010000100100100000001000001
1000000000000000000000000000000000000000001
1111111111111111111111111111111111111111111