1111111111111111111111111111111111111111111
10000000000000000000e00000000000000e0000001
10001000101000010100000e0001000000000100001
101000e000000e0000000000000000001000000e001
100000000100000010001000100e0000000e0000001
100010000e0001000e0000000000100000000000001
10000100000000000000100000000e00000W0000e01
100e0000010000e0000000001000000000000000001
10000100000000000000100000e00001000e0000001
100e000001000000010000010000000000000010001
10000100000010000000e0000000000000000000001
100100010010000101000010010010000000100e001
1000e000000000000000e000000000000e000000001
1111111111111111111111111111111111111111111