1111111111111111111111111111111111111111111111111
1000000000d00000000000000000d00000000000000000001
1000011111111111100000111111111111100000000000001
1000s10000000000100000100000000000100s00000000001
100001000000s000100s001000000s0000111111111111101
100000000000000010000010000000000000000d000000101
10000111001110001000001001011111111111111111001d1
1000010000001000111111100100000000000000000000101
1000010000001000000d000001000000s0000000111111101
100001000s001111111111111100000000000000100000001
1011110000000000000000000000000000000000100000001
10100001111111111s000000000000s111111111100000001
1d1000000000000s11111111111111110000s000101111001
10100000000000000000000d0000000000000000101000001
10111111111100011111111111111111111111001d1000001
1000000000s10001s00000000000000d00000000101000001
1000000000011111000000000111111111111111101111001
1000000000000d00000000000100000000010000000000001
10000000000111110000000001000000000100000s0000001
100000100001000000000000s100000s00010100000000001
1000001111110011111111111100000000010100000000001
100000000000001000000000000000000001d1s0000000001
1011111111110011111111111111111111110111111111101
101000000000000000000000d0000000000001000s0000101
1d100s00001111111111111111111111111000000000001d1
101000000000000d0000000000000000001s0000000000101
1011111111111111111000000011111100111111111110101
1000000000s00000001111111110000000000000s00000001
1N00000000000000000000d00000000000000000000000001
1111111111111111111111111111111111111111111111111