1111111111111111111111111111111111111111111111111
1000000000d00000000000000000d00000000000000000001
1000011111111111100000111111111111100000000000001
1000e10000000000100000100000000000100e00000000001
100001000000e000100e001000000e0000111111111111101
100000000000000010000010000000000000000d000000101
10000111001110001000001001011111111111111111001d1
1000010000001000111111100100000000000000000000101
1000010000001000000d000001000000e0000000111111101
100001000e001111111111111100000000000000100000001
1011110000000000000000000000000000000000100000001
10100001111111111e000000000000e111111111100000001
1d1000000000000e11111111111111110000e000101111001
10100000000000000000000d0000000000000000101000001
10111111111100011111111111111111111111001d1000001
1000000000e10001e00000000000000d00000000101000001
1000000000011111000000000111111111111111101111001
1000000000000d00000000000100000000010000000000001
10000000000111110000000001000000000100000e0000001
100000100001000000000000e100000e00010100000000001
1000001111110011111111111100000000010100000000001
100000000000001000000000000000000001d1e0000000001
1011111111110011111111111111111111110111111111101
101000000000000000000000d0000000000001000e0000101
1d100e00001111111111111111111111111000000000001d1
101000000000000d0000000000000000001e0000000000101
1011111111111111111000000011111100111111111110101
1000000000e00000001111111110000000000000e00000001
1N00000000000000000000d00000000000000000000000001
1111111111111111111111111111111111111111111111111