1111111111111111111111111111111111111111111111111
1000000000000000000000000000000000000000000000001
1d11111111d11111100000111111d11111100000s00000001
1000010000000000100000100000000000100000000000001
100001000000s000100s001000000s00001111111111111d1
1000000000000000100000100000000000000000000000101
1000011111111000100000100101111111111111111100101
1000010000001000111d11100100000000000000000000101
10000100000010000000000001000000s0000000111111101
101111000s001111111111111100000000000000100000001
10100d0000000000000000000000000000000000100000001
101001111111111111111111111111111111111d1011111d1
1010000000000000000010000000000000000000100000001
10100000000000000000d0000000000000000000101000001
1d11111111111111111111111111111111111100101000001
1000000000010000000000000000000000000000101000001
10000000000100000000000001111111111111111d1111111
100000s000011111110000000100000000010000000000001
10000000000000000100000001000000000100000s0000001
1000000000000000010000000100000s00010000000000001
11d111111111111d1111111111000000000101111111111d1
1000100000000010000000000000000000010100000000001
10001000s000001111111111111111111111d100000010001
10001000000000000000000000000000000001000s0010001
1000100s00111111111111111111111111100100000010001
1000d00000100000000000000000000000100000000010001
10001111111d1111111111111111111100111111111110001
10N000000000000000s000100000000000000000000000001
10000000000000000000001000000s0000000000000000001
1111111111111111111111111111111111111111111111111